+x+++x+++x+
xb/@@/@@/bx
+/@@@p@@@/+
+@@@///@@@+
+@@/@/@/@@+
xa///@///Ax
+@@/@/@/@@+
+@@@///@@@+
+/@@@s@@@/+
+b/@@/@@/b+
+x+++x+++x+
