+x+++x+++x+
x++//////+x
++/////c//+
+/////////+
+///p////++
x///////++x
+/+/////+/+
+////+//+/+
+/////c//s+
+/+/////+/+
x///+///+/x
+x+++x+++x+
