xtxxxtxxxtx
t----s----t
x---------x
x---------x
x---------x
t----p----t
x---------x
x---------x
x---------x
t---------t
xtxxxtxxxtx