xxxxxxxxxxx
x----p----x
x---------x
x---------x
x---------x
x----s----x
x---------x
x---------x
x---------x
x---------x
xxxxxxxxxxx